{
    "1A": "NA",
    "1W": "NA",
    "4E": "NA",
    "7E": "NA",
    "8S": "NA",
    "A4": "NA",
    "A5": "NA",
    "A9": "NA",
    "AD": "NOC",
    "AE": "NOC",
    "AF": "LIC",
    "AG": "NOC",
    "AL": "UMC",
    "AM": "LMC",
    "AO": "UMC",
    "AR": "UMC",
    "AS": "UMC",
    "AT": "OEC",
    "AU": "OEC",
    "AW": "NOC",
    "AZ": "UMC",
    "BA": "UMC",
    "BB": "NOC",
    "BD": "LIC",
    "BE": "OEC",
    "BF": "LIC",
    "BG": "UMC",
    "BH": "NOC",
    "BI": "LIC",
    "BJ": "LIC",
    "BM": "NOC",
    "BN": "NOC",
    "BO": "LMC",
    "BR": "UMC",
    "BS": "NOC",
    "BT": "LMC",
    "BW": "UMC",
    "BY": "UMC",
    "BZ": "UMC",
    "C4": "NA",
    "C5": "NA",
    "C6": "NA",
    "C7": "NA",
    "C8": "NA",
    "C9": "NA",
    "CA": "OEC",
    "CD": "LIC",
    "CF": "LIC",
    "CG": "LMC",
    "CH": "OEC",
    "CI": "LMC",
    "CL": "OEC",
    "CM": "LMC",
    "CN": "UMC",
    "CO": "UMC",
    "CR": "UMC",
    "CU": "UMC",
    "CV": "LMC",
    "CW": "NOC",
    "CY": "NOC",
    "CZ": "OEC",
    "DE": "OEC",
    "DJ": "LMC",
    "DK": "OEC",
    "DM": "UMC",
    "DO": "UMC",
    "DZ": "UMC",
    "EC": "UMC",
    "EE": "OEC",
    "EG": "LMC",
    "ER": "LIC",
    "ES": "OEC",
    "ET": "LIC",
    "EU": "NA",
    "FI": "OEC",
    "FJ": "UMC",
    "FM": "LMC",
    "FO": "NOC",
    "FR": "OEC",
    "GA": "UMC",
    "GB": "OEC",
    "GD": "UMC",
    "GE": "LMC",
    "GH": "LMC",
    "GL": "NOC",
    "GM": "LIC",
    "GN": "LIC",
    "GQ": "NOC",
    "GR": "OEC",
    "GT": "LMC",
    "GU": "NOC",
    "GW": "LIC",
    "GY": "LMC",
    "HK": "NOC",
    "HN": "LMC",
    "HR": "NOC",
    "HT": "LIC",
    "HU": "UMC",
    "ID": "LMC",
    "IE": "OEC",
    "IL": "OEC",
    "IM": "NOC",
    "IN": "LMC",
    "IQ": "UMC",
    "IR": "UMC",
    "IS": "OEC",
    "IT": "OEC",
    "JG": "NOC",
    "JM": "UMC",
    "JO": "UMC",
    "JP": "OEC",
    "KE": "LIC",
    "KG": "LIC",
    "KH": "LIC",
    "KI": "LMC",
    "KM": "LIC",
    "KN": "NOC",
    "KP": "LIC",
    "KR": "OEC",
    "KV": "LMC",
    "KW": "NOC",
    "KY": "NOC",
    "KZ": "UMC",
    "L4": "NA",
    "L5": "NA",
    "L7": "NA",
    "L8": "NA",
    "LA": "LMC",
    "LB": "UMC",
    "LC": "UMC",
    "LI": "NOC",
    "LK": "LMC",
    "LR": "LIC",
    "LS": "LMC",
    "LT": "NOC",
    "LU": "OEC",
    "LV": "NOC",
    "LY": "UMC",
    "M2": "NA",
    "MA": "LMC",
    "MC": "NOC",
    "MD": "LMC",
    "ME": "UMC",
    "MF": "NOC",
    "MG": "LIC",
    "MH": "UMC",
    "MK": "UMC",
    "ML": "LIC",
    "MM": "LIC",
    "MN": "LMC",
    "MO": "NOC",
    "MP": "NOC",
    "MR": "LMC",
    "MT": "NOC",
    "MU": "UMC",
    "MV": "UMC",
    "MW": "LIC",
    "MX": "UMC",
    "MY": "UMC",
    "MZ": "LIC",
    "NA": "UMC",
    "NC": "NOC",
    "NE": "LIC",
    "NG": "LMC",
    "NI": "LMC",
    "NL": "OEC",
    "NO": "OEC",
    "NP": "LIC",
    "NZ": "OEC",
    "OE": "NA",
    "OM": "NOC",
    "PA": "UMC",
    "PE": "UMC",
    "PF": "NOC",
    "PG": "LMC",
    "PH": "LMC",
    "PK": "LMC",
    "PL": "OEC",
    "PR": "NOC",
    "PS": "LMC",
    "PT": "OEC",
    "PW": "UMC",
    "PY": "LMC",
    "QA": "NOC",
    "RO": "UMC",
    "RS": "UMC",
    "RU": "NOC",
    "RW": "LIC",
    "S1": "NA",
    "S2": "NA",
    "S3": "NA",
    "S4": "NA",
    "SA": "NOC",
    "SB": "LMC",
    "SC": "UMC",
    "SD": "LMC",
    "SE": "OEC",
    "SG": "NOC",
    "SI": "OEC",
    "SK": "OEC",
    "SL": "LIC",
    "SM": "NOC",
    "SN": "LMC",
    "SO": "LIC",
    "SR": "UMC",
    "SS": "LIC",
    "ST": "LMC",
    "SV": "LMC",
    "SX": "NOC",
    "SY": "LMC",
    "SZ": "LMC",
    "TC": "NOC",
    "TD": "LIC",
    "TG": "LIC",
    "TH": "UMC",
    "TJ": "LIC",
    "TL": "LMC",
    "TM": "UMC",
    "TN": "UMC",
    "TO": "UMC",
    "TR": "UMC",
    "TT": "NOC",
    "TV": "UMC",
    "TZ": "LIC",
    "UA": "LMC",
    "UG": "LIC",
    "US": "OEC",
    "UY": "NOC",
    "UZ": "LMC",
    "VC": "UMC",
    "VE": "UMC",
    "VI": "NOC",
    "VN": "LMC",
    "VU": "LMC",
    "WS": "LMC",
    "XC": "NA",
    "XD": "NA",
    "XE": "NA",
    "XJ": "NA",
    "XL": "NA",
    "XM": "NA",
    "XN": "NA",
    "XO": "NA",
    "XP": "NA",
    "XQ": "NA",
    "XR": "NA",
    "XS": "NA",
    "XT": "NA",
    "XU": "NA",
    "XY": "NA",
    "YE": "LMC",
    "Z4": "NA",
    "Z7": "NA",
    "ZA": "UMC",
    "ZF": "NA",
    "ZG": "NA",
    "ZJ": "NA",
    "ZM": "LMC",
    "ZQ": "NA",
    "ZW": "LIC"
}
